

F                                       25,25,25


WE               ./textures/neon_a.png

NO ./textures/neon2.png
SO               ./textures/neon1.png
        EA       ./textures/neon_b.png
	
C 5,5,5

111111111111111111
100000000000001111
111001000100000001
100001111100000001
100001000000000001
100000000011111001
100111100000000001
100000000001100001
1100000N0000100001
111111111111111111




