

F                                       25,25,25


WE         ./textures/neon_a.png 
SO               ./textures/neon1.png
        EA       ./textures/neon_b.png
	
C 5,5,5

NO ./textures/neon2.png
111111111111111111
100000000000001111
111001000100000001
1000011111000  001
100001000000000001
100000000011111001
100111100000000001
100000000001111001
1100000N00001 1001
1111111111111 1111
