F                                       255,255,255


WE               ./textures/blue.png

NO ./textures/red.png
SO               ./textures/green.png
        EA       ./textures/purple.png
	
C 0,0,0

                 1111111111111111111111111
                 1000000000110000000000001
                 1011000000011111010000101
                 1011000000010010000100011
                 101100N000000000000000111
                 1011000000000000000000001
                 1111111111111111111111111