F                                       255,255,255


WE               ./textures/test.png

NO ./textures/red.png
SO               ./textures/blue.png
        EA       ./textures/purple.png
	
C 0,0,0

111111111
100000001
100000001
111100001
100000111
1000N0001
100000001
111111111