F                                       200,200,9


WE               ./textures/wall_west.png

NO ./textures/wall_north.png
SO               ./textures/wall_south.png
        EA       ./textures/wall_east.png
	
C 225,30,0
111111111111111111111111111
100000000000000000000000001
100000000000000000000000001
1000000000000N0000000000001  111111
100000000000000000000000001  100001
100000000000000000000000001  111111
111111111111111111111111111