F                                       255,255,255


WE               ./textures/wall_west.png

NO ./textures/red.png
SO               ./textures/blue.png
        EA       ./textures/purple.png
	
C 0,0,0

111111111111111111
100000000000000001
100000000000000001
100000000000000001
100000000000000001
100000000000000001
100000000000000001
100000000000000001
1000000N0000000001
111111111111111111
