F                                       255,255,255


WE               ./textures/blue.png

NO ./textures/red.png
SO               ./textures/green.png
        EA       ./textures/purple.png
	
C 0,0,0
1111111111111111111111111
1000000000000000000000001
1000000000000000000000001
1000000000000000000000001
1000000000000000000000001
1000000000001111111111111
1000000000000000000000001
1000000000000000000000001
1000000000000000000000001
1000000000000000000000001
1000000000000000000000001
1000000000000000000000001
1000000000000000000000001
1E00000000000000000000001
1111111111111111111111111