F                                       255,255,255


WE               ./textures/wall_west.png

NO ./textures/wall_north.png
SO               ./textures/wall_south.png
        EA       ./textures/wall_east.png
	
C 2,2,2
1111111111111111111111111
1000000000000000000000001
1000000000000000000000001
1000000000000000000000001
1000000000000000000000001
1000000000001111111111111
1000000000000000000000001
1000000000000000000000001
1000000000000000000000001
1000000000000000000000001
1000000000000000000000001
1000000000000000000000001
1000000000000000000000001
100000000000N000000000001
1111111111111111111111111