F                                       255,255,255


WE               ./textures/wall_west.png

NO ./textures/red.png
SO               ./textures/blue.png
        EA       ./textures/purple.png
	
C 0,0,0

1111111
1000001
10000S1
111111