F                                       80,120,60


WE               ./textures/flower3.png

NO ./textures/flower4.png
SO               ./textures/flower6.png
        EA       ./textures/flower52.png
	
C 160,200,220

111111111111111111
100000000000000001
100000000000000001
100000000000000001
100000000000000001
100000000000000001
100000000000000001
100000000000000001
1000000N0000000001
111111111111111111
