F                                      128,128,128


WE               ./textures/wall_west.png

NO ./textures/wall_north.png
SO               ./textures/wall_south.png
        EA       ./textures/wall_east.png
	
C 50,50,50

111111111111111111
100000000000000001
100000000000000001
100000000000000001
100000000000000001
100000000000000001
100000000000000001
100000000000000001
1000000N0000000001
111111111111111111

